WWWWW..WWWWW
W...WWWW...W
W.WWW..WWW.W
..W......W..
W.WWW..WWW.W
W...WWWW...W
WWWWW..WWWWW
